20 20
####################
#.................s#
#...####...#####...#
#......##......#...#
###.....#########..#
#....####....#.....#
#....s..#...###....#
#####...#.....#....#
#.......####....#..#
#..#...s...#..###..#
#..#.....######....#
#..####..#.....s...#
#s....#..#...#######
####....s......s...#
#.....#..########..#
#.....#..#.s.......#
#..####..#..###....#
#..#.s......#....###
#@.#....#...#.s....#
####################